7 7
1011111
1110001
1000001
1000001
1000001
1000001
1111111

13